a=a,
adresse=lakcim,
alle=mind,
arbeit=munka,
(ich)arbeite=dolgozom,
ma=-en -on,
aus=bol bol,
asien=azsiai,
aufWidersehen=viszont latasra,
auch=is,
afelsaft=almale,
b=b,
baume=fa fak,
bad=furdoszoba,
beide=ketten,
bequem=kenyelem,
besteck=evoeszkoz,
besuchen=meglatogatni,
bin=vagyok,
bist=(te)vagy,
bruder=fiu testver,
bleiben=marad,
bier=sor,
bis bald=viszlat,
blau=kek,
blumen=viragok,
braun=barna,
brauchen=szukseges,
bratst=sut,
brot=kenyer,
brief=level,
buchstaben=betu,
buch=konyv,
bucher=konyvek,
bugele=vasal,
buro=iroda,
butter=vaj,
c=c,
d=d,
du=te,
der=a(ferfi),
decke den= lefed megterit,
die=a(no),
das=a(gyermek),
dritte=harmadik,
d=d,
dach=teto,
diesem=ez,
dort=ott,
dosenoffner=kozervnyito,
du=te,
e=e,
er=ferfi_fiu,
erdbeere=eper,
eine=egy,
erste=az elso,
entschuldigen sie=bocsanat,
erde=fold,
etwas=valami


 