f=f,
fahrrader=bicikli,
familie=csalad,
farbe=szinu,
frau=feleseg,
fernseher=tv,
fenster=ablak,
flaschenoffner=sornyito,
freunde=baratok,
fruhling=tavasz,
fühlen=erezni,
funfte=otodik,
fuBboden=padlo,
g=g,
gabeln=villa,
ganz= minden vagy teljesen,
garten=kert,
geschlossen=zarva,
gefallt=tetszik,
gemuse=zoldseg,
geschirr=edenyek,
gehen=megy setal,
gelb=sarga,
gerade=eppem,
gern=szivesen vagy szeret,
gestern=tegnap,
gießt=ontozni,
glaser=pohar,
gras=fu,
grau=szurke,
groB=nagy,
grosBvater=nagyapa,
grosBmutter=nagymama,
grun=zold,
h=h,
hallo=szia,
habe=van,
haben=birtokolni,
hange= kiteriteni kiakasztani,
hat die=rendelkezik a,
hauptstadt=fovaros,
haus=haz,
haustur=haz ajto,
herbst=osz,
heiB=forro,
heute=ma,
hier=itt,
himmel=az eg,
hinter=mogot,
horen=halgatni,
hund=kutya,
i=i,
ich=en,
ihnen=oket,
ihr=ti,
im=-ban -ben,
instrument=hangszer,
interesant=erdekes,
ist=van,
ist aus=valohanna valosi,
j=j,
jahrezeiten=evszakok