k=k,
kaffe=kave,
kartoffeln=krumpli,
kalt=hideg,
karotten=sargarepa,
katze=macska,
keller=pince,
klein=kicsi,
kind=gyermek,
klasse=osztaly,
keinen=nem,
kino=mozi,
kirsche=cseresznye,
kochen=fozni,
kommen=jon,
korkenzieher=dugohuzo,
kuche=konyha,
l=l,
lange=hosszu,
laut=zajos,
lese=olvasok,
lehrerin=tanarno,
lernen=tanulas,
lernst=tanulsz,
lernt=tanul,
leute=emberek,
lieben=szeret,
liegt=talalhato,
loffel=kanal,
m=m,
(was)macht=mit csinal,
mag=szereti,
melone=dinye,
menschen=emberek,
messer=kes,
mich=nekem magam,
machen=csinalni,
mann=ferfi,
meine=az en,
mit=val vel,
mir=nekem,
monate=honap,
m√∂chten=szeretne vagy akar,
morgen=reggel vagy holnap,
mutter=anya,
n=n,
neben=mellett,
neue=ujj,
nicht=nem,
o=o,
onkel=nagybacsi,
oben=felett,
oder=vagy,
offen=nyitva
