p=p,
pfanne=serpenyo,
putzen=tiszta vagy takarit,
r=r,
r√§umen auf=takarit,
regnet es=esik az eso,
reis=rizs,
rot=piros,
reifen=gumiabroncs,
q=q,
s=s,
satz=mondat,
saugt=porszivozas,
schalen=meghamozni,
schaut=kinex megnez,
schwester=lany testver,
schnee=ho,
schon=mar,
schon hier=mar itt,
schreibe=irok,
scheint=sut,
schneiden=vagott,
schneit=havazik,
schreibst du=irsz,
schreibt er=o ir,
schlafzimmer=haloszoba,
schmutzig=piszkos,
schhreibtisch=iroasztal,
schule=iskola,
schuler=tanulo,
schwarz=fekete,
skretarin=titkarno,
sechste=hatodik,
sehen=lat,
seid=vagytok,
seinen=ove,
sekt=pezsgo,
servietten=szalveta,
sessel=fotel,
setzen=leul,
sie=no_lany on,
siebte=hetedik,
sich=maga,
sind=vagyunk,
sommer=nyar,
sprache=nyelv,
spielen=jatszani,
spult=mosogat,
sofa=kanape,
sohn=valakinek a fia,
soll=megtegyen valamit,
sonne=nap,
staub=por,
stecke=tenni,
steht=all,
student=egyetemista,
studiert=tanul,
suppe=leves,
t=t,
tag=nap,
tante=nagyneni,
tanzen=tancolni,
tee=tea,
teller=tanyerok,
tisch=asztal,
toast=piritos,
tochter=valakinek a lanya,
topf=fazek,
tut mir leid=sajnalom,
tchus=viszlat,
trinke=iszom
