u=u,
urlaub=vakacio,
und=es,
uns=minket,
unser=a mienk,
unten=alul,
unterricht=oktatas,
v=v,
vater=apa,
verstehen=megerteni,
vierte=negyedik,
wie viel=mennyi,
vielmals=sokszo,
vor=elott,
w=w,
war=volt,
warm=meleg,
wascht=mosni,
waschmaschine=mosogep,
wasser=viz,
welche=melyik milyen,
wein=bor,
wer ist das=ki ez,
weiter=tovabb,
weiB=feher,
wetter=idojaras,
wir=mi vagy nekunk,
wie geth's=hogy vagy,
welchem=melyik,
wie= hogy hogyan,
wieder=ujra,
windig=szeles,
winter=tel,
woche=egy het,
wohin=hol hova,
wohnen=lakik,
wohnzimmer=nappali,
wohnung=lakasom,
wo=hol,
wo sind wir=hol vagyunk,
wolke=felho,
wollen=akarni,
wort=szo,
x=x,
y=y,
was brauchen wir noch=mire van meg szuksegunk,
es ist...=valamilyen ido van, 
z=z,
zahle=szamolok,
zeit=ido,
zweite=masodik,
zwibeln=hagyma